1111111111111111
1C10000P00010101
11100CC00CC1E101
100CC00CC0000001
1111111111111111