1111111111111111
1010000P00010101
10000CC00CC1E101
100CC00CC0010101
1111111111111111