1111111111111111
1PCEC000C0000001
1111111111111111