1111111111111111
1000000P00000001
10000CC00CC0EC01
100CC00CC00CCC01
1111111111111111