111111111
100P10E01
1001C0101
100000C01
111111111