1111111111111111
1PCCCCCCCCCCCCE1
1111111111111111