111111111
100P10E01
1001C0101
1C0000C01
111111111
