111111111
100P00E01
1000C0001
100000C01
111111111