11111111111111
10000000000E01
1001C00CP00000001
11111111111111