111111111
100000E01
1CP0000E1
111111111