01111111111111111
100C0000000000001
100000000P0000001
100000000000000E1
11111111111111111