11111111111
1S84320m;.cDF1
100P00C0E01
11111111111