111111111
100000P01
1CP0000E1
111111111